NO ./textures/pokerclubs
SO ./textures/pokerheart
F 255,  255,   255
WE /dev/urandom
C 255,255,255
EA ./textures/pokerspades


        1111111111111111111111111
        1000000000110000000001001
        1011000000D0000000E00D001
        100D000000100000000001001
111111111011000001110000000000001
1000000000110000011111D1111111111
11110111111111011100000010001
11110111111111011101010010001
11000000110101011100000010001
10000000000000001100000010001
10000000000000001101010010001
11000001110101011111011110001
11110111 1110101 101111010001
11111111 1111111 111111111111