NO ./textures/pokerclubs
SO ./textures/pokerheart
WE ./textures/pokerdiamond
EA ./textures/pokerspades

F 255,255,255
C 255,255,255

        1111111111111111111111111
        1000000000110000000001001
        1011000000D0000000E00D001
        1000000000100000000001001
111111111011000001110000000000001
1000000000D00000011111D111D111111
11110111111111011100000010001
11110111111111011101010010001
11000000110101011100000010001
1000000000000000D0000000D0001
10000000000000001101010010001
11000001110101011111011110001
11110111 1110101 101111010001
11111111 1111111 111111111111