NO ./textures/pokerclubs
SO ./textures/pokerheart
WE ./textures/pokerdiamond
EA ./textures/pokerspades

F 220,100,42
C 225,30,42

1111111111111111111111111
1000000000110000000000001
1011000001110000000000001
1000000000000000000000001
1100010101101001111N00001
1101011111101011011110101
1001011111101011000000101
1001000000001000011110001
1101011111101011011110101
1001011111100011000000101
1001000000000000011110001
1101011011100011011110101
1001011001101011000000101
1001000000000000011010001
1101011111001011011010101
1001011100001011000000101
1001000000000000011110001
1111111111111111111111111