SO ./path_to_the_south_texture
WE ./path_to_the_west_texture

F                       220     ,        100      ,       0
C 225,30,0

EA ./path_to_the_ea111st_texture
NO ./path_to_the_north_texture
                   111
       111111111111000111111111111
        1000000000110000000000001
        1011000001110000000000001
        1001000000000000000000001
111111111011000001110000000000001        111
100000000011000001110111111111111     111111
111101111111110111000000100011111     1011 1   
11110111 111110111010100100011111     1111111
110000001101010111000000100S1
10000000000000001100000011111
10000000000000001101010011 1                           1
1100000111010101111101111111111
11110111 1110101 101111010001
11111111 1111111 1111111111110